111111111
1P0000001
101010101
1C0101001
100C000E1
111111111
