1111111111111111111
1000000000C00000001
1010010100101001001
100C00000000000C001
1010010010101010001
1000000000000000001
1E000C0000000000P01
1111111111111111111