111111111
1000P0011
1000001C1
10E0C0011
111111111