111111111
1111E1111
111111111
100000001
10C0000P1
111111111