1111111
1P00001
101C101
1C0101
100E001
1111111