1111111111111111111111
1000000000000000000001
1000000000000000000001
1000000000000000000001
100000000000C1C0000001
1000000000001P1000E001
100000000000C1C0000001
1000000000000000000001
1000000000000000000001
1111111111111111111111